####################
#S                 #
# ################ #
# #              # #
# # ###### ##### # #
# # #      #   # # #
# # #### # # # # # #
# #    # # # # # # #
# #### # # # # ### #
#      #   # #   # #
##################E#
