####################
#S..#..............#
#...#.........#....#
#...#....#....#....#
#........#....#....#
#...#....#....#...E#
#...#....#....#....#
#...#....#....#....#
#S..#.........#....#
#...#.........#....#
####################
