####################
#A#                #
# #                #
# #   #####        #
#     #   #   B    #
# a   #   #   b    #
#     #####        #
#                  #
####################
